Add Share=Share hinzufügen
All files encrypted=Alle Dateien verschlüsselt
All files protected=Alle Dateien geschützt
All files unprotected=Alle Dateien ungeschützt
Allocation method=Verteilungsmethode
Array must be Started to view Shares=Das Array muss **gestartet** sein um Shares zu sehen
Automatically split any directory as required=Jegliches Verzeichnis aufteilen wie nötig
Automatically split only the top five directory levels as required=Nur die obersten fünf Verzeichnisse aufteilen wie nötig
Automatically split only the top four directory levels as required=Nur die obersten vier Verzeichnisse aufteilen wie nötig
Automatically split only the top level directory as required=Nur das oberste Verzeichnis aufteilen wie nötig
Automatically split only the top three directory levels as required=Nur die obersten drei Verzeichnisse aufteilen wie nötig
Automatically split only the top two directory levels as required=Nur die obersten zwei Verzeichnisse aufteilen wie nötig
Comments=Kommentare
Compute All=Berechne alle
Compute=Berechnen
Disk Shares=Festplattenfreigabe
Do not use reserved names=Verwende keine reservierten Namen
Do not use pool names=Verwende keine Pool Namen
Enable Copy-on-write=Copy-on-write aktivieren
Enter a name for the share=Gib einen Namen für den Share ein
Excluded disks=Ausgeschlossene Festplatte
Fill-up=Auffüllen
Free=Frei
has been deleted=wurde gelöscht
HDD=HDD
High-water=High-water
Included disks=Eingeschlossene Festplatten
Invalid Characters=Ungültiges Zeichen
Invalid share name=Ungültiger Share Name
Manual do not automatically split directories=Manuell: es werden keine Verzeichnisse automatisch aufgeteilt
Minimum free space=Minimum freier Speicherplatz
Missing share name=Fehlender Share Name
Most-free=Am meisten frei
Mover takes no action=Mover wird nicht ausgeführt
Mover transfers files from array to cache=Mover transferiert Dateien vom Array in den Cache
Mover transfers files from cache to array=Mover transferiert Dateien vom Cache auf das Array
next user share=Nächster Nutzer Share
Only=Nur
Prefer=Bevorzugen
previous user share=Vorheriger Nutzer Share
Recompute=Neuberechnen
Rule=Regel
Select cache pool=Cache Pool auswählen
Set when adding new share only=
Share contains data=Share enthält Daten
Share is empty=Share is leer
Share is outside the list of designated disks=Share ist außerhalb der Liste von vorgesehenen Festplatten
Share Settings=Share Einstellungen
Share status=Share Status
Size=Größe
Some or all files unencrypted=Einiger oder alle Dateien sind unverschlüsselt
Some or all files unprotected=Einiger oder alle Dateien sind ungeschützt
Split level=Aufteilungslevel
SSD=SSD
There are no exportable disk shares=Es existieren keine Festplattenfreigaben
There are no exportable user shares=Es existieren keine Benutzer Shares
Time Machine volume size limit=Time Machine Volumen Größe
Unknown encryption state=Unbekannter Verschlüsselungsstatus
Use cache pool for new filesdirectories=Benutze den Cache Pool (für neue Dateien/Verzeichniesse)
User Shares=Nutzer Shares
Volume dbpath=Volume dbpath
You cannot use the following within share names=Du kannst folgendes nicht im Namen einer Share verwenden