; Translation Credit.  Will appear in CA's credits
translationCredit=<AutorIn> (<Sprache>)
Cancel=Abbrechen

; My PSAs / banners
Happy New Year=Frohes neues Jahr
Happy Holidays from Andrew, Tracey, and family=Frohe Feiertage von Andrew, Tracey und der Familie
Please Enjoy Responsibly=Geniesse bitte verantwortungsvoll
Popup Blocked CA requires popups to be enabled under certain circumstances You must white list your server within your browser to allow popups=Ein Popup wurde blockiert CA braucht Popups unter bestimmten Bedingungen. Du musst Popups für deinen Server in deinem Browser erlauben.
Docker Service Not Enabled - Only Plugins Available To Be Installed Or Managed=Docker Service nicht aktiviert - Es sind nur Plugins zum Installieren oder Verwalten verfügbar.
Community Applications works best when cookies are enabled in your browser Certain features may not be available=Community Applications funktioniert am besten wenn Browser Cookies aktiviert sind. Bestimmte Funktionen könnten nicht verfügbar sein.
Backup Server Active Some icons may not appear, and plugin installations may be affected=Backup Server aktiv. Einige Icons erscheinen vielleicht nicht und die Plugin Installation ist eventuell beeinträchtigt.

; Sorting Options
Sorting options=Sortieroptionen
Sorting options unavailable=Sortieroptionen nicht verfügbar
Sort By Name Ascending=Aufsteigend nach Name sortieren
Sort By Name Descending=Absteigend nach Name sortieren
Sort By Downloads=Nach Downloads sortieren
Sort By Trend=Nach Trend sortieren
Sort By Date Added=Nach Hinzufügedatum sortieren
; Initial disclaimer translations
Disclaimer=Haftungsausschluss
All applications listed here are 3rd party additions to Unraid Neither the authors of Community Applications nor Limetech make any warranty as to the suitability of any application listed here=All aufgelisteten Programme sind von Drittanbietern zu Unraid hinzugefügt Weder die Autoren der Community Applications noch Limetech übernehmen jegliche Garantie über die Angemessenheit der aufgeführten Programme.
Every attempt is made to ensure that only safe and compatible applications are present=Es wird jeder Versuch unternommen, um sicherzustellen, dass nur sichere und kompatible Programme verfügbar sind.
Application Policy=Anwendungsrichtlinie
I Understand=Ich verstehe
Installations of apps disabled You must accept the warning to be able to install applications=Die Installation von Apps ist deaktiviert. Du musst die Warnung akzeptieren um Programme installieren zu können.
Click here=Klick hier

; Plugin Disclaimer
Plugins=Plugins
Community Applications contains both docker containers and plugin applications Plugins are designed for OS enhancements, and run with full privileges on your system and are clearly identified within CA=Community Applications enthält Docker Container und Plugin Programme. Plugins sind für Betriebssystemverbesserungen entwickelt und werden mit allen Rechten auf dem System ausgeführt und sind klar innerhalb CA identifiziert.
Plugin Note=Plugin Notiz

; Multi Install
Install Plugin Applications=Plugin Programme installieren

; Searches
Search=Suche
Please enter search term=Bitte Suchwort eingeben
Click Here To Get More Results From DockerHub=Klick hier um zusätzliche Ergebnisse von DockerHub zu erhalten
No Matching Applications Found On Docker Hub=Keine passenden Programme auf DockerHub gefunden
No Matching Applications Found=Keine passenden Programme gefunden

; Install Plugin title of openbox
Install Plugin=Plugin installieren

; Remove App from previously installed
Delete Template=Vorlage löschen
Yes, delete it=Ja, löschen

; Uninstall  popup
Uninstall Application=Programm deinstallieren
Yes uninstall it=Ja, deinstallieren

; Remove Private Application
Remove Private Application=Privates Programm entfernen
Yes, remove it=Ja, entfernen

; App Pinning
Click to pin this application=Klicke um das Programm zu makieren
Click to unpin this application=Klicke um die Makierung aufzuheben

; Branch installations
Choose A Branch To Install=Wähle einen Branch um zu Installieren

; Multiple application installs
; no apps selected
Install Selected Applications=Ausgewählte Programme installieren

Yes, install it=Ja, dieses installieren

; Multi-install popup
Yes, install them=Ja, diese installieren
Cookies not enabled Plugins must be separately installed from docker applications=Cookies sind nicht aktiviert Plugins müssen seperat von Docker Programme installiert werden.
Docker applications will be installed utilizing the most recently saved template with no user input on your part=Docker Programme werden mit der aktuellsten Vorlage on Nutzereingabe installiert.
Updating Support Links=Support Links werden aktualisiert
Finished Installing If the DONE button did not appear, then you will need to click the red X in the top right corner=Installation abgeschlossen. Falls die FERTIG Taste nicht erschienen ist, klicke bitte das rote X in der oberen rechten Ecke.

; error messages
No data was returned It is probable that another browser session has rebooted your server Reloading this browser tab will probably fix this error=Keine Daten erhalten. Es kann sein, dass eine andere Browserinstanz den Server neu gestartet hat. Das Neuladen dieses Tabs löst das Problem wahrscheinlich.
An error occurred Could not find any %s Apps=Es ist ein Fehler aufgetreten. Es konnten keine %s Programme gefunden werden.
Download of appfeed failed=Herunterladen des Appfeed ist fehlgeschlagen.
; the %s here refers to a function being called
Something really went wrong here=Es ist etwas wirklich schief gegangen
Post the ENTIRE contents of this message in the Community Applications Support Thread=Poste den GESAMTEN Inhalt dieser Nachricht in den Community Application Support Thread.
Unknown error happened Please post a screenshot in the support thread of the Statistics screen=Ein unbekannter Fehler ist aufgetreten. Bitte poste eine Bilschirmaufnahme in den Support Thread von dem Statistik Fenster.
Something really wrong happened Reloading the Apps tab will probably fix the problem=Es ist etwas richtig schief gegangen. Das Neuladen des App Tabs wird das Problem wahrscheinlich beheben.
This plugin has a duplicated name from another plugin %s This will impact your ability to install both plugins simultaneously=Dieses Plugin hat deinen bereits verwendeten Name von einem anderen Plugin %s. Dies wird die Möglichkeit beide Plugins gleichzeitig zu installieren beeinträchtigen.

; CA Sections Keep the length reasonable
MENU=MENÜ
Installed Apps=Installierte Apps
Previous Apps=Vorherige Apps
Pinned Apps=Markierte Apps
CATEGORIES=KATEGORIEN
New Apps=Neue Apps
Updated Apps=Aktualisierte Apps
Random Apps=Zufällig Apps
Top New Installs=Top neue Installationen
Trending Apps=Trend-Apps
All Apps=All Apps
OTHER=ANDERE
Settings=Einstellungen
Statistics=Statistiken
Credits=Namensnennungen
Support=Support
VERSION=VERSION
Change Log=Änderungsprotokoll

; Credits
Development=Entwicklung
Additional Contributions=Zusätzliche Beiträge
GUI Layout Design=GUI Layoutgestaltung
Application Feed=
Additional Testing=Zusätzliches Testen
Moderation=
Additional Libraries=Zusätzliche Bibliotheken
Copyright=Urheberrecht
Translation=Übersetzung

; Statistics page
Deprecated Applications are able to still be installed if you have previously had them installed New installations of these applications are blocked unless you enable Display Deprecated Applications within CAs General Settings=Veralterte Programme können immer noch installiert werden falls du sie bereits installiert hattest. Neue Installationen diese Programme sind blockiert ausser due hast die Option Zeige veralterte Programm in den Allgemeinen Einstellungen von CA aktiviert.
The following applications are blacklisted CA will never allow you to install or reinstall these applications=Die folgenden Programme werden der Ausschlussliste hinzugefügt. CA wird nicht mehr erlauben diese zu installieren.
While highly not recommended to do, incompatible applications can be installed by enabling Display Incompatible Applications within CAs General Settings=Es ist möglich inkomaptible Programme zu installieren wenn man in den Allgemeinen Einstellungen von CA Zeige nicht kompatible Programme aktiviert. Allerdings wird davon stark abgeraten.
This display is informational ONLY=Diese Anzeige dient NUR zur Information.
unknown=unbekannt
Last Change To Application Feed=
Number Of Docker Applications=Anzahl Docker Programme
Number Of Plugin Applications=Anzahl Plugin Programme
Number Of Templates=Anzahl Vorlagen
Number Of Repositories=Anzahl Repositories
Number Of Private Docker Applications=Anzahl privater Docker Programme
Number Of Invalid Templates=Anzahl ungültige Vorlagen
Number Of Template Errors=Anzahl Vorlagenfehler
Number Of Blacklisted Apps=Anzahl Programme auf der Auschlussliste
Number Of Incompatible Applications=Anzahl inkomaptibler Programme
Number Of Deprecated Applications=Anzahl veralterter Programme
Number Of Moderation Entries=Anzahl der Moderationsbeiträge
Primary Server=Primärer Server
Backup Server=Backup Server

; Statistics Popup Titles
Repository List=Repository Liste
All Invalid Templates Found=All ungültigen Vorlagen gefunden
Template Errors=Vorlagenfehler
All Moderation Entries=Alle Moderationsbeiträge

; Statistics Popup
No invalid templates found=Keine ungültigen Vorlagen gefunden.
These templates are invalid and the application they are referring to is unknown=Diese Vorlagen sind ungültig und das verweisende Programm ist unbekannt.
No templates were automatically fixed=Keine Vorlage würde automatisch korregiert.
All of these errors found have been fixed automatically=Alle diese Fehler wurde automatisch behoben.
Note that many of these errors can be avoided by following the directions=Vele dieser Fehler vermieden werden können, wenn man den Richtlinien folgt.
HERE=HIER
The following plugins have duplicated filenames and are not able to be installed simultaneously=Die folgenden Plugins haben doppelte Dateinamen und können daher nicht gleichzeitig installiert sein.
The following docker applications refer to the same docker repository but may have subtle changes in the template to warrant this=Die folgenden Docker Programme verweisen auf das gleiche Docker Repository, aber haben kleine Änderungen welche dies rechtfertigen.
If any of these entries are incorrect then contact the moderators of CA to discuss=Falls einer dieser Einträge inkorrekt ist, kontaktiere die Moderatoren von CA um dies zu diskutieren.
Global Repository Comments=Globale Repository Kommentare
Applied to all applications=(Auf alle Programme angewandt)
Individual Application Moderation=Individualle Programmmoderation

; Misc
Community Applications Changelog=Community Applications Änderungsprotokoll

; Categories try not to be excessively long This is displayed on the left of CA screen

Backup=Backup
Cloud=Cloud
Downloaders=Downloaders
Game Servers=Spielserver
Home Automation=Heimautomatisierung
Media Applications=Medienanwendungen
Books=Bücher
Music=Musik
Photos=Bilder
Video=Video
Other=Andere
Media Servers=Medienserver
Network Services=Netzwerkservices
DNS=DNS
FTP=FTP
Management=Verwaltung
Messenger=Kurzmitteilungen
Proxy=Proxy
VOIP=COIP
VPN=VPN
Web=Web
Productivity=Produktivität
Security=Sicherheit
Tools Utilities=Werkzeuge / Dienstprogramme
System=System
Themes=Themes
Utilities=Dienstprogramme
Plugins=Plugins
Private Apps=Private Apps
Uncategorized=Ohne Kategorie

; Categories displayed within a popup or on the card
GameServers=Spielserver
HomeAutomation=Heimautomatisierung
MediaApp=Medienprogramme
MediaAppBooks=Medienprogramme:Bücher
MediaAppMusic=Medienprogramme:Musik
MediaAppPhotos=Medienprogramme:Bilder
MediaAppVideo=Medienprogramme:Video
MediaAppOther=Medienprogramme:Andere
MediaServer=Medienserver
MediaServerBooks=Medienserver:Bücher
MediaServerMusic=Medienserver:Musik
MediaServerPhotos=Medienserver:Bilder
MediaServerVideo=Medienserver:Video
MediaServerOther=Medienserver:Andere
Network=Netzwerk
NetworkDNS=Netzwerk:DNS
NetworkFTP=Netzwerk:FTP
NetworkManagement=Netzwerk:Verwaltung
NetworkProxy=Netzwerk:Proxy
NetworkVOIP=Netzwerk:VOIP
NetworkVPN=Netzwerk:VPN
NetworkWeb=Netzwerk:Web
NetworkOther=Netzwerk:Andere
Tools=Werkzeuge
ToolsSystem=Werkzeuge:System
ToolsThemes=Werkzeuge:Themes
ToolsUtilities=Werkzeuge:Utilities
Plugins=Plugins
Other=Andere
OtherUncategorized=Andere:Uncategorized
and %s more=und %s mehr

; App Popup Related
Donate To Author=Spende an AutorIn
Donate To Maintainer=Spende an BetreuerIn
Author=AutorIn
Maintainer=BetreuerIn
DockerHub=DockerHub
Application Template=Programvorlage
Base OS=Basis OS
DockerHub Stars=DockerHub Sterne
Added to CA=Hinzugefügt zu CA
Date Updated=Aktualisierungsdatum
Current Version=Aktuelle Version
Minimum OS=Mindest OS
Max OS=Maximales OS
Total Downloads=Totale Downloads
Licence=Lizenz
30 Day Trend=30 Tage Trend
Ranked #%s=Stelle #%s
; as in Trending up or down arrow
Trending %s=Trendgin %s
; as in As of some date
As of %s=Stand %s
This application template has been blacklisted=Diese Programvorlage wurde der Auschlussliste hinzugefügt.
This application template has been deprecated=Diese Programvorlage ist veraltert.
This application is not compatible with your version of Unraid=Diese Programm ist nicht kompatible mit deiner Version von Unraid.
Another browser tab or device has updated the displayed templates Some actions are not available=Ein anderer Browser Tab oder ein anderes Gerät hat die angezeige Vorlage aktualisiert. Einige Aktionen sind nicht verfügbar.
Reinstall default=Neuinstallation (standard)
WebUI=WebUI
Reinstall=Neuinstallieren
Install=Intallieren
Project=Projekt
Install Using The Templates Default Tag=Instalieren mit den standard Tags der Vorlage
Moderator Comments=Moderator Kommentare
Note not all authors keep up to date on change logs=Beachte, dass nicht alle Autoren das Änderungsprotokoll aktualisieren.
Note not all maintainers keep up to date on change logs=Beachte, dass nicht alle Betreuer das Änderungsprotokoll aktualisieren.
;the following if using a space you MUST use nbsp  but keep it down to one word if at all possible
Donate=Spende
Currently Installed Version=Aktuelle nbsp installierte nbsp Version
Install The Update=Update nbsp installieren
; as in you have the latest version already installed
Latest Version=Aktuelle Version
Multi Language Support=Mehrsprachenunterstützung
; as in more than 100000
More than %s=Mehr als %s

; Graphs
Trend Per Month=Trend pro Monat
Downloads Per Month=Downloads pro Monat
Total Downloads=Totale Downloads

; Multi install script
Installing docker applications %s=Docker Programm %s wird installiert.
Starting %s=%s wird gestartet.
%s failed to start You should install it by itself to fix the errors=%s konnte nicht starten. Du solltest es selbst installieren, um die Fehler zu beheben.
Setting installed applications to autostart=Setze Autostart der installierten Programme.
Docker Application Installation finished=Installation der Docker Programme abgeschlossen.

; Application Cards
Private dockerHub Conversion=Private (dockerHub Conversion)
Go to the project page=Gehe zur Projektseite
Go to the support thread=Gehe zum Supportthread
Uninstall Application=Programm deinstallieren
Remove Private Application=Privates Programm entfernen
Remove Application From List=Programm von Liste entfernen
Check off to select multiple reinstalls=
Go to the plugin settings=Gehe zu den Plugin Einstellungen
Click to reinstall the application using default values=Klicke um das Programm mit Standardwerte neu zu installieren
Click to edit the application values=Klicke, um die Programmwerte zu ändern
Click to reinstall=Klicke für Neuinstallation
Click to install=Klicke für Installation
Install plugin=Plugin installieren
Click to go to the WebUI=Klicke, um zur WebUI zu gehen
This application has been marked as being Beta=Dieses Programm ist als Beta markiert.
This application template has been deprecated=Diese Programmvorlage ist veraltet.
This application is not compatible with your version of Unraid=Dieses Programm ist nicht kompatible mit deiner Version von Unraid.
This application template has been blacklisted=Diese Programmvorlage ist auf der Auschlussliste.
Search for more applications from %s=Suche mehr Programme von %s
Click for more information=Klicke für mehr Informationen

; Dockerhub searches
Search For Containers From %s=Suche Containers von %s
Search for similar containers=Suche ähnliche Container

; Page Navigation
Displaying %s - %s of %s=Zeige %1$s - %2$s (von %3$s)

Updating Content=Inhalt wird aktualisiert
Language=Sprache
Switch to this language=Wechsel zu dieser Sprache
Country Code=Ländercode
Install Language Pack=Sprachenpaket installieren
Remove Language Pack=Sprachenpaket entfernen
Update Language Pack=Sprachenpaket aktualisieren
Installed Version=Installierte Version

; Help Text
This chooses how to sort the results=Diese Auswahl bestimmt die Sortierung der Ergebnisse.
These icons respectively will Install or Edit an application=Diese Icons installieren oder ändern ein Programm.
Clicking these icons will take you to an application's GUI or settings=Das Klicken auf die Icons bringt dich in die GUI des Programms oder in die Einstellungen.
This will update an application=Dies wird das Programm aktualisieren.
This will take you to the appropriate support thread for an application=Dies bringt die zu dem Supportthread des Programms.
This will immediately switch to the language=Dies wird sofort die Sprache ändern.
This will take you to the project page for an application=Dies bringt die zur Projektseite des Programms.
Clicking this icon will uninstall the application or delete it from the lists depending upon your current section=Das Klicken auf das Icon deinstalliert das Programm oder entfernt es von der Liste abhängig von deinem Reiter.
Clicking these icons will pin or unpin an application for later viewer from the Pinned Apps section=Das Klicken auf diese Icons wird ein Programm makieren oder nicht mehr makieren, so dass du sie später in dem Markierte Apps Reiter sehen kannst.
Clicking this will display more information about the application NOTE You can also click on the applications icon to display more information=Ein Klick aus dies zeigt mehr Informationen über das Programm. Beachte, dass du auch das Programmicon klicken kannst um mehr Informationen zu erhalten.
Clicking this will display any warnings or extra comments about the application=Ein Klick hier zeigt alle Warnungen oder zusätzliche Kommentare des Programms.
On the previous apps section you can select multiple applications to install simultaneously=In dem Vorherige Progamme Reiter kannst du mehrere Programme zur gleichzeitigen Installation auswählen.
This is the recommended version to install by the application author themselves=Dies ist die vom/von der AutorIn empfholene Version zur Installation. 
For support for this plugin visit=Für Unterstützung für dieses Plugin gehe zu
To view the policies Community Applications has=Um die Richtlinien der Community Applications zu sehen
